Джордж — Оруэлл 1984
Владимир Набоков — Лолита
Михаил Булгаков — Собачье сердце  
Илья Ильф, Евгений Петров — Двенадцать стульев 
Габриэль Гарсиа Маркес — Сто лет одиночества 
Федор Достоевский — Идиот, Бесы, Братья Карамазовы
Артур Конан-Дойль — Приключения Шерлока Холмса  
Лев Толстой — Анна Каренина
Эрих Мария Ремарк — Три товарища, На западном фронте без перемен, Триумфальная арка, Жизнь взаймы
Маргарет Митчелл — Унесённые ветром
О.Генри — Рассказы
Уильям Шекспир — Ромео и Джульетта 
Оскар Уайльд — Портрет Дориана Грея
Джером Д. Сэлинджер — Над пропастью во ржи
Александр Дюма — Граф Монте-Кристо
Уильям Шекспир — Гамлет
Джон Толкиен — Властелин колец
Джейн Остин — Гордость и предубеждение
Иоганн Вольфганг фон Гёте — Фауст
Ричард Бах — Чайка по имени Джонатан Ливингстон, Иллюзии, Мост через вечность
Виктор Гюго — Собор Парижской Богоматери
Джек Лондон — Мартин Иден
Джером К. Джером — Трое в лодке, не считая собаки
Рэй Брэдбери — 451 градус по Фаренгейту
Аркадий и Борис Стругацкие — Пикник на обочине
Джек Лондон — Белый Клык
Жюль Верн — Таинственный остров
Иван Бунин — Тёмные аллеи
Фрэнсис Скотт Фицджеральд — Великий Гэтсби
Джованни Боккаччо — Декамерон
Пауло Коэльо — Алхимик
Борис Акунин — Приключения Эраста Фандорина
Теодор Драйзер — Американская трагедия
Эмили Бронте — Грозовой перевал
Харпер Ли — Убить пересмешника
Эрнест Хемингуэй — Прощай оружие
Умберто Эко — Имя Розы
Элинор Портер — Поллианна
Жорж Санд — Консуэло
Алексей Толстой — Живой труп